************************* *************************
*                                   * *           *
* * *** *** ******************* ***** * * * * * ***
* * *   * *   *   * * *                 * * * *   *
***** * * *** * *** * * *** *** * ***** *** *******
*     * *   * *     *   * * *   *     * * *       *
*** ******* * ***** *** * * ******* * *** * *** * *
* *     *     *   *     *     *     * *       * * *
* * *********** * ********* * ******* * *** * *****
*     * *   * * *     *     * *   *   * *   *     *
* ***** * *** * ***** *** *** * * * ******* ***** *
* *     *   * * *       * * *   * * * *   *     * *
* * ***** *** *** *** *** * ***** *** *** ***** ***
*     *   * * *     * *       * *       * *     * *
* * ***** * * * *** * *** ***** *** ***** *** * * *
* * *           *   * *   *     *     *     * *   *
* ******* ******* * *** ******* *** * * ********* *
*   *       *     * *   *         * * * *     *   *
*** * * ***** * ***** ******* ******* * * * * * ***
*     *   *   *         *       * *   * * * * *   *
*** * *** * *** ***** ******* * * * *** *** * *** *
* * * * * * * *     * * *     *       *   * * * * *
* * *** * * * *** *** * * ********* ***** * * * * *
* * *   * * *     *   * *   *     *   *     * * * *
* * * *** ******* ***** * ******* *** * *** *** * *
* * *     *   *   *     * *     * * * *   *   * * *
* ***** * * * *** * ***** ***** * * * ***** * * * *
* *     * * * *     * *     *           * * *   * *
* ***** * *** * ***** *********** ******* * * * * *
*     * * * *             *   *     * * *   * * * *
* * * *** * *** * ***** ***** ******* * *** * * * *
* * *   * * *   *     * *             *     * * * *
* ***** * * *********** ******* *** * ******* * * *
* *     *   *   *     * *   *   * * *       * *   *
* * * ********* * ***** * *** *** *** * ***** * ***
* * *       *           *   * * *   * *   *   *   *
* ******* ***** ******* * *** * * *** *** * *******
*   *   *   *   *   *     *         * * * * * * * *
* ***** * *** ***** * ******* * ***** * *** * * * *
*     *           *     *     * * *   *   *     * *
*** *** ********************* *** *** *** *** * * *
*   *   *     *               * * *   *       *   *
*** *** * ***** * ******* *** * * *** * *** ***** *
*       *       *   *   * * *   *     *   * *   * *
*** ***** ***** *** *** *** ***** * * *** *** * * *
*       *   *   * * *       *   * * *   * *   *   *
*** *** * ***** * ***** *** *** *** *** ******* ***
*   *     *   *   *     * * * *     * * *     *   *
* ***** *** ***** ******* * * *** *** * *** ***** *
*   *                 *           *         *     *
* ***** * * * *** * ***** ***** * * * ***** * * * *
* *     * * * *     * *     *           * * *   * *
* ***** * *** * ***** *********** ******* * * * * *
*     * * * *             *   *     * * *   * * * *
* * * *** * *** * ***** ***** ******* * *** * * * *
* * *   * * *   *     * *             *     * * * *
* ***** * * *********** ******* *** * ******* * * *
* *     *   *   *     * *   *   * * *       * *   *
* * * ********* * ***** * *** *** *** * ***** * ***
* * *       *           *   * * *   * *   *   *   *
* ******* ***** ******* * *** * * *** *** * *******
*   *   *   *   *   *     *         * * * * * * * *
* ***** * *** ***** * ******* * ***** * *** * * * *
*     *           *     *     * * *   *   *     * *
*** *** ********************* *** *** *** *** * * *
*   *   *     *               * * *   *       *   *
*** *** * ***** * ******* *** * * *** * *** ***** *
*       *       *   *   * * *   *     *   * *   * *
*** ***** ***** *** *** *** ***** * * *** *** * * *
*       *   *   * * *       *   * * *   * *   *   *
*** *** * ***** * ***** *** *** *** *** ******* ***
*   *     *   *   *     * * * *     * * *     *   *
* ***** *** ***** ******* * * *** *** * *** ***** *
*   *                 *           *         *     *
************************* *************************