************************* ***************************************************************************
*                                   * *                                               * *           *
* * *** *** ******************* ***** * * * * * *** * *** *** ******************* ***** * * * * * ***
* * *   * *   *   * * *                 * * * *   * * *   * *   *   * * *                 * * * *   *
***** * * *** * *** * * *** *** * ***** *** *********** * * *** * *** * * *** *** * ***** *** *******
*     * *   * *     *   * * *   *     * * *       *     * *   * *     *   * * *   *     * * *       *
*** ******* * ***** *** * * ******* * *** * *** * *** ******* * ***** *** * * ******* * *** * *** * *
* *     *     *   *     *     *     * *       * * * *     *     *   *     *     *     * *       * * *
* * *********** * ********* * ******* * *** * ***** * *********** * ********* * ******* * *** * *****
*     * *   * * *     *     * *   *   * *   *     *     * *   * * *     *     * *   *   * *   *     *
* ***** * *** * ***** *** *** * * * ******* ***** * ***** * *** * ***** *** *** * * * ******* ***** *
* *     *   * * *       * * *   * * * *   *     * * *     *   * * *       * * *   * * * *   *     * *
* * ***** *** *** *** *** * ***** *** *** ***** *** * ***** *** *** *** *** * ***** *** *** ***** ***
*     *   * * *     * *       * *       * *     * *     *   * * *     * *       * *       * *     * *
* * ***** * * * *** * *** ***** *** ***** *** * * * * ***** * * * *** * *** ***** *** ***** *** * * *
* * *           *   * *   *     *     *     * *   * * *           *   * *   *     *     *     * *   *
* ******* ******* * *** ******* *** * * ********* * ******* ******* * *** ******* *** * * ********* *
*   *       *     * *   *         * * * *     *   *   *       *     * *   *         * * * *     *   *
*** * * ***** * ***** ******* ******* * * * * * ***** * * ***** * ***** ******* ******* * * * * * ***
*     *   *   *         *       * *   * * * * *   *     *   *   *         *       * *   * * * * *   *
*** * *** * *** ***** ******* * * * *** *** * *** *** * *** * *** ***** ******* * * * *** *** * *** *
* * * * * * * *     * * *     *       *   * * * * * * * * * * * *     * * *     *       *   * * * * *
* * *** * * * *** *** * * ********* ***** * * * * * * *** * * * *** *** * * ********* ***** * * * * *
* * *   * * *     *   * *   *     *   *     * * * * * *   * * *     *   * *   *     *   *     * * * *
* * * *** ******* ***** * ******* *** * *** *** * * * * *** ******* ***** * ******* *** * *** *** * *
* * *     *   *   *     * *     * * * *   *   * * * * *     *   *   *     * *     * * * *   *   * * *
* ***** * * * *** * ***** ***** * * * ***** * * * * ***** * * * *** * ***** ***** * * * ***** * * * *
* *     * * * *     * *     *           * * *   * * *     * * * *     * *     *           * * *   * *
* ***** * *** * ***** *********** ******* * * * * * ***** * *** * ***** *********** ******* * * * * *
*     * * * *             *   *     * * *   * * * *     * * * *             *   *     * * *   * * * *
* * * *** * *** * ***** ***** ******* * *** * * * * * * *** * *** * ***** ***** ******* * *** * * * *
* * *   * * *   *     * *             *     * * * * * *   * * *   *     * *             *     * * * *
* ***** * * *********** ******* *** * ******* * * * ***** * * *********** ******* *** * ******* * * *
* *     *   *   *     * *   *   * * *       * *   * *     *   *   *     * *   *   * * *       * *   *
* * * ********* * ***** * *** *** *** * ***** * *** * * ********* * ***** * *** *** *** * ***** * ***
* * *       *           *   * * *   * *   *   *   * * *       *           *   * * *   * *   *   *   *
* ******* ***** ******* * *** * * *** *** * ******* ******* ***** ******* * *** * * *** *** * *******
*   *   *   *   *   *     *         * * * * * * * *   *   *   *   *   *     *         * * * * * * * *
* ***** * *** ***** * ******* * ***** * *** * * * * ***** * *** ***** * ******* * ***** * *** * * * *
*     *           *     *     * * *   *   *     * *     *           *     *     * * *   *   *     * *
*** *** ********************* *** *** *** *** * * *** *** ********************* *** *** *** *** * * *
*   *   *     *               * * *   *       *   *   *   *     *               * * *   *       *   *
*** *** * ***** * ******* *** * * *** * *** ***** *** *** * ***** * ******* *** * * *** * *** ***** *
*       *       *   *   * * *   *     *   * *   * *       *       *   *   * * *   *     *   * *   * *
*** ***** ***** *** *** *** ***** * * *** *** * * *** ***** ***** *** *** *** ***** * * *** *** * * *
*       *   *   * * *       *   * * *   * *   *   *       *   *   * * *       *   * * *   * *   *   *
*** *** * ***** * ***** *** *** *** *** ******* ***** *** * ***** * ***** *** *** *** *** ******* ***
*   *     *   *   *     * * * *     * * *     *   *   *     *   *   *     * * * *     * * *     *   *
* ***** *** ***** ******* * * *** *** * *** ***** * ***** *** ***** ******* * * *** *** * *** ***** *
*   *                 *           *         *     *   *                 *           *         *     *
************************* ***************************************************************************
*                                                                                     * *           *
* * *** *** ******************* *************** ********************************* ***** * * * * * ***
* * *   * *   *   * * *                 * * * *   * * *   * *   *   * * *                 * * * *   *
***** * * *** * *** * * *** *** * ***** *** *********** * * *** * *** * * *** *** * ***** *** *******
*     * *   * *     *   * * *   *     * * *       *     * *   * *     *   * * *   *     * * *       *
*** ******* * ***** *** * * ******* * *** * *** * *** ******* * ***** *** * * ******* * *** * *** * *
* *     *     *   *     *     *     * *       * * * *     *     *   *     *     *     * *       * * *
* * *********** * ********* * ******* * *** * ***** * *********** * ********* * ******* * *** * *****
*     * *   * * *     *     * *   *   * *   *     *     * *   * * *     *     * *   *   * *   *     *
* ***** * *** * ***** *** *** * * * ******* ***** * ***** * *** * ***** *** *** * * * ******* ***** *
* *     *   * * *       * * *   * * * *   *     * * *     *   * * *       * * *   * * * *   *     * *
* * ***** *** *** *** *** * ***** *** *** ***** *** * ***** *** *** *** *** * ***** *** *** ***** ***
*     *   * * *     * *       * *       * *     * *     *   * * *     * *       * *       * *     * *
* * ***** * * * *** * *** ***** *** ***** *** * * * * ***** * * * *** * *** ***** *** ***** *** * * *
* * *           *   * *   *     *     *     * *   * * *           *   * *   *     *     *     * *   *
* ******* ******* * *** ******* *** * * ********* * ******* ******* * *** ******* *** * * ********* *
*   *       *     * *   *         * * * *     *   *   *       *     * *   *         * * * *     *   *
*** * * ***** * ***** ******* ******* * * * * * ***** * * ***** * ***** ******* ******* * * * * * ***
*     *   *   *         *       * *   * * * * *   *     *   *   *         *       * *   * * * * *   *
*** * *** * *** ***** ******* * * * *** *** * *** *** * *** * *** ***** ******* * * * *** *** * *** *
* * * * * * * *     * * *     *       *   * * * * * * * * * * * *     * * *     *       *   * * * * *
* * *** * * * *** *** * * ********* ***** * * * * * * *** * * * *** *** * * ********* ***** * * * * *
* * *   * * *     *   * *   *     *   *     * * * * * *   * * *     *   * *   *     *   *     * * * *
* * * *** ******* ***** * ******* *** * *** *** * * * * *** ******* ***** * ******* *** * *** *** * *
* * *     *   *   *     * *     * * * *   *   * * * * *     *   *   *     * *     * * * *   *   * * *
* ***** * * * *** * ***** ***** * * * ***** * * * * ***** * * * *** * ***** ***** * * * ***** * * * *
* *     * * * *     * *     *           * * *   * * *     * * * *     * *     *           * * *   * *
* ***** * *** * ***** *********** ******* * * * * * ***** * *** * ***** *********** ******* * * * * *
*     * * * *             *   *     * * *   * * * *     * * * *             *   *     * * *   * * * *
* * * *** * *** * ***** ***** ******* * *** * * * * * * *** * *** * ***** ***** ******* * *** * * * *
* * *   * * *   *     * *             *     * * * * * *   * * *   *     * *             *     * * * *
* ***** * * *********** ******* *** * ******* * * * ***** * * *********** ******* *** * ******* * * *
* *     *   *   *     * *   *   * * *       * *   * *     *   *   *     * *   *   * * *       * *   *
* * * ********* * ***** * *** *** *** * ***** * *** * * ********* * ***** * *** *** *** * ***** * ***
* * *       *           *   * * *   * *   *   *   * * *       *           *   * * *   * *   *   *   *
* ******* ***** ******* * *** * * *** *** * ******* ******* ***** ******* * *** * * *** *** * *******
*   *   *   *   *   *     *         * * * * * * * *   *   *   *   *   *     *         * * * * * * * *
* ***** * *** ***** * ******* * ***** * *** * * * * ***** * *** ***** * ******* * ***** * *** * * * *
*     *           *     *     * * *   *   *     * *     *           *     *     * * *   *   *     * *
*** *** ********************* *** *** *** *** * * *** *** ********************* *** *** *** *** * * *
*   *   *     *               * * *   *       *   *   *   *     *               * * *   *       *   *
*** *** * ***** * ******* *** * * *** * *** ***** *** *** * ***** * ******* *** * * *** * *** ***** *
*       *       *   *   * * *   *     *   * *   * *       *       *   *   * * *   *     *   * *   * *
*** ***** ***** *** *** *** ***** * * *** *** * * *** ***** ***** *** *** *** ***** * * *** *** * * *
*       *   *   * * *       *   * * *   * *   *   *       *   *   * * *       *   * * *   * *   *   *
*** *** * ***** * ***** *** *** *** *** ******* ***** *** * ***** * ***** *** *** *** *** ******* ***
*   *     *   *   *     * * * *     * * *     *   *   *     *   *   *     * * * *     * * *     *   *
* ***** *** ***** ******* * * *** *** * *** ***** * ***** *** ***** ******* * * *** *** * *** ***** *
*   *                 *           *         *     *   *                 *           *         *     *
*************************************************************************** *************************