*************************+***************************************************************************
*                        +++++++    * *                                               * *           *
* * *** *** *******************+***** * * * * * *** * *** *** ******************* ***** * * * * * ***
* * *   * *   *   * * *    +++++        * * * *   * * *   * *   *   * * *                 * * * *   *
***** * * *** * *** * * ***+*** * ***** *** *********** * * *** * *** * * *** *** * ***** *** *******
*     * *   * *     *   * *+*   *     * * *       *     * *   * *     *   * * *   *     * * *       *
*** ******* * ***** *** * *+******* * *** * *** * *** ******* * ***** *** * * ******* * *** * *** * *
* *     *     *   *     *  +  *     * *       * * * *     *     *   *     *     *     * *       * * *
* * *********** * *********+* ******* * *** * ***** * *********** * ********* * ******* * *** * *****
*     * *   * * *     *  +++* *   *   * *   *     *     * *   * * *     *     * *   *   * *   *     *
* ***** * *** * ***** ***+*** * * * ******* ***** * ***** * *** * ***** *** *** * * * ******* ***** *
* *     *   * * *       *+* *   * * * *   *     * * *     *   * * *       * * *   * * * *   *     * *
* * ***** *** *** *** ***+* ***** *** *** ***** *** * ***** *** *** *** *** * ***** *** *** ***** ***
*     *   * * *     * *  +    * *       * *     * *     *   * * *     * *       * *       * *     * *
* * ***** * * * *** * ***+***** *** ***** *** * * * * ***** * * * *** * *** ***** *** ***** *** * * *
* * *           *   * *+++*     *     *     * *   * * *           *   * *   *     *     *     * *   *
* ******* ******* * ***+******* *** * * ********* * ******* ******* * *** ******* *** * * ********* *
*   *       *     * *+++*         * * * *     *   *   *       *     * *   *         * * * *     *   *
*** * * ***** * *****+******* ******* * * * * * ***** * * ***** * ***** ******* ******* * * * * * ***
*     *   *   *+++++++  *       * *   * * * * *   *     *   *   *         *       * *   * * * * *   *
*** * *** * ***+***** ******* * * * *** *** * *** *** * *** * *** ***** ******* * * * *** *** * *** *
* * * * * * * *+++  * * *     *       *   * * * * * * * * * * * *     * * *     *       *   * * * * *
* * *** * * * ***+*** * * ********* ***** * * * * * * *** * * * *** *** * * ********* ***** * * * * *
* * *   * * *    +*   * *   *     *   *     * * * * * *   * * *     *   * *   *     *   *     * * * *
* * * *** *******+***** * ******* *** * *** *** * * * * *** ******* ***** * ******* *** * *** *** * *
* * *     *   *  +*     * *     * * * *   *   * * * * *     *   *   *     * *     * * * *   *   * * *
* ***** * * * ***+* ***** ***** * * * ***** * * * * ***** * * * *** * ***** ***** * * * ***** * * * *
* *     * * * *+++  * *     *           * * *   * * *     * * * *     * *     *           * * *   * *
* ***** * *** *+***** *********** ******* * * * * * ***** * *** * ***** *********** ******* * * * * *
*     * * * *  +++++++++  *   *     * * *   * * * *     * * * *             *   *     * * *   * * * *
* * * *** * *** * *****+***** ******* * *** * * * * * * *** * *** * ***** ***** ******* * *** * * * *
* * *   * * *   *     *+*      +++++++*     * * * * * *   * * *   *     * *             *     * * * *
* ***** * * ***********+*******+*** *+******* * * * ***** * * *********** ******* *** * ******* * * *
* *     *   *   *     *+*   *+++* * *+      * *   * *     *   *   *     * *   *   * * *       * *   *
* * * ********* * *****+* ***+*** ***+* ***** * *** * * ********* * ***** * *** *** *** * ***** * ***
* * *       *  +++++++++*   *+* *   *+*   *   *   * * *       *           *   * * *   * *   *   *   *
* ******* *****+******* * ***+* * ***+*** * ******* ******* ***** ******* * *** * * *** *** * *******
*   *   *   *+++*   *     *  +      *+* * * * * * *   *   *   *   *   *     *         * * * * * * * *
* ***** * ***+***** * *******+* *****+* *** * * * * ***** * *** ***** * ******* * ***** * *** * * * *
*     *+++++++    *     *    +* * *  +*   *     * *     *           *     *     * * *   *   *     * *
*** ***+*********************+*** ***+*** *** * * *** *** ********************* *** *** *** *** * * *
*   *  +*     *+++++++++++++++* * *  +*       *   *   *   *     *               * * *   *       *   *
*** ***+* *****+* ******* *** * * ***+* *** ***** *** *** * ***** * ******* *** * * *** * *** ***** *
*  +++++*+++++++*   *   * * *   *  +++*   * *   * *       *       *   *   * * *   *     *   * *   * *
***+*****+***** *** *** *** ***** *+* *** *** * * *** ***** ***** *** *** *** ***** * * *** *** * * *
*  +++++*+  *   * * *       *   * *+*   * *   *   *       *   *   * * *       *   * * *   * *   *   *
*** ***+*+***** * ***** *** *** ***+*** ******* ***** *** * ***** * ***** *** *** *** *** ******* ***
*   *  +++*   *   *     * * * *  +++* * *     *   *   *     *   *   *     * * * *     * * *     *   *
* ***** *** ***** ******* * * ***+*** * *** ***** * ***** *** ***** ******* * * *** *** * *** ***** *
*   *                 *  +++++++++*         *     *   *                 *           *         *     *
*************************+***************************************************************************
*                        +++++++++++++++++++++++++++++++++++++++++++++++++++++++++    * *           *
* * *** *** ******************* *************** *********************************+***** * * * * * ***
* * *   * *   *   * * *                 * * * *   * * *   * *   *   * * *    +++++        * * * *   *
***** * * *** * *** * * *** *** * ***** *** *********** * * *** * *** * * ***+*** * ***** *** *******
*     * *   * *     *   * * *   *     * * *       *     * *   * *     *   * *+*   *     * * *       *
*** ******* * ***** *** * * ******* * *** * *** * *** ******* * ***** *** * *+******* * *** * *** * *
* *     *     *   *     *     *     * *       * * * *     *     *   *     *  +  *     * *       * * *
* * *********** * ********* * ******* * *** * ***** * *********** * *********+* ******* * *** * *****
*     * *   * * *     *     * *   *   * *   *     *     * *   * * *     *  +++* *   *   * *   *     *
* ***** * *** * ***** *** *** * * * ******* ***** * ***** * *** * ***** ***+*** * * * ******* ***** *
* *     *   * * *       * * *   * * * *   *     * * *     *   * * *       *+* *   * * * *   *     * *
* * ***** *** *** *** *** * ***** *** *** ***** *** * ***** *** *** *** ***+* ***** *** *** ***** ***
*     *   * * *     * *       * *       * *     * *     *   * * *     * *  +    * *       * *     * *
* * ***** * * * *** * *** ***** *** ***** *** * * * * ***** * * * *** * ***+***** *** ***** *** * * *
* * *           *   * *   *     *     *     * *   * * *           *   * *+++*     *     *     * *   *
* ******* ******* * *** ******* *** * * ********* * ******* ******* * ***+******* *** * * ********* *
*   *       *     * *   *         * * * *     *   *   *       *     * *+++*         * * * *     *   *
*** * * ***** * ***** ******* ******* * * * * * ***** * * ***** * *****+******* ******* * * * * * ***
*     *   *   *         *       * *   * * * * *   *     *   *   *+++++++  *       * *   * * * * *   *
*** * *** * *** ***** ******* * * * *** *** * *** *** * *** * ***+***** ******* * * * *** *** * *** *
* * * * * * * *     * * *     *       *   * * * * * * * * * * * *+++  * * *     *       *   * * * * *
* * *** * * * *** *** * * ********* ***** * * * * * * *** * * * ***+*** * * ********* ***** * * * * *
* * *   * * *     *   * *   *     *   *     * * * * * *   * * *    +*   * *   *     *   *     * * * *
* * * *** ******* ***** * ******* *** * *** *** * * * * *** *******+***** * ******* *** * *** *** * *
* * *     *   *   *     * *     * * * *   *   * * * * *     *   *  +*     * *     * * * *   *   * * *
* ***** * * * *** * ***** ***** * * * ***** * * * * ***** * * * ***+* ***** ***** * * * ***** * * * *
* *     * * * *     * *     *           * * *   * * *     * * * *+++  * *     *           * * *   * *
* ***** * *** * ***** *********** ******* * * * * * ***** * *** *+***** *********** ******* * * * * *
*     * * * *             *   *     * * *   * * * *     * * * *  +++++++++  *   *     * * *   * * * *
* * * *** * *** * ***** ***** ******* * *** * * * * * * *** * *** * *****+***** ******* * *** * * * *
* * *   * * *   *     * *             *     * * * * * *   * * *   *     *+*      +++++++*     * * * *
* ***** * * *********** ******* *** * ******* * * * ***** * * ***********+*******+*** *+******* * * *
* *     *   *   *     * *   *   * * *       * *   * *     *   *   *     *+*   *+++* * *+      * *   *
* * * ********* * ***** * *** *** *** * ***** * *** * * ********* * *****+* ***+*** ***+* ***** * ***
* * *       *           *   * * *   * *   *   *   * * *       *  +++++++++*   *+* *   *+*   *   *   *
* ******* ***** ******* * *** * * *** *** * ******* ******* *****+******* * ***+* * ***+*** * *******
*   *   *   *   *   *     *         * * * * * * * *   *   *   *+++*   *     *  +      *+* * * * * * *
* ***** * *** ***** * ******* * ***** * *** * * * * ***** * ***+***** * *******+* *****+* *** * * * *
*     *           *     *     * * *   *   *     * *     *+++++++    *     *    +* * *  +*   *     * *
*** *** ********************* *** *** *** *** * * *** ***+*********************+*** ***+*** *** * * *
*   *   *     *               * * *   *       *   *   *  +*     *+++++++++++++++* * *  +*       *   *
*** *** * ***** * ******* *** * * *** * *** ***** *** ***+* *****+* ******* *** * * ***+* *** ***** *
*       *       *   *   * * *   *     *   * *   * *  +++++*+++++++*   *   * * *   *  +++*   * *   * *
*** ***** ***** *** *** *** ***** * * *** *** * * ***+*****+***** *** *** *** ***** *+* *** *** * * *
*       *   *   * * *       *   * * *   * *   *   *  +++++*+  *   * * *       *   * *+*   * *   *   *
*** *** * ***** * ***** *** *** *** *** ******* ***** ***+*+***** * ***** *** *** ***+*** ******* ***
*   *     *   *   *     * * * *     * * *     *   *   *  +++*   *   *     * * * *  +++* * *     *   *
* ***** *** ***** ******* * * *** *** * *** ***** * ***** *** ***** ******* * * ***+*** * *** ***** *
*   *                 *           *         *     *   *                 *  +++++++++*         *     *
***************************************************************************+*************************